[
  {
    "name": "Classic Maze",
    "maze": [
      "####################",
      "#........#.........#",
      "#.###....#....###..#",
      "#...#..........#...#",
      "#...#.###..###.#...#",
      "#.........#........#",
      "#.###.#.#.#.#.###..#",
      "#.....#...#.......##",
      "#####.#.###.#.######",
      "#........#.........#",
      "#.###.#######.###..#",
      "#...#........#.....#",
      "#...#.###..###.#...#",
      "#........#.........#",
      "####################"
    ]
  },
  {
    "name": "The Galactic Core",
    "maze": [
      "####################",
      "#..................#",
      "#.####.######.####.#",
      "#.#....#....#....#.#",
      "#.#.##...##...##.#.#",
      "#...#  ######  #...#",
      "###.#  #    #  #.###",
      "#...#  #    #  #...#",
      "###.#  ######  #.###",
      "#...#...####...#...#",
      "#.#.###......###.#.#",
      "#.#....######....#.#",
      "#.####........####.#",
      "#..................#",
      "####################"
    ]
  },
  {
    "name": "Seashells",
    "maze": [
      "####################",
      "#..................#",
      "#.#..###....##..##.#",
      "#.#....#....#....#.#",
      "#.#.##.#.##.#.##.#.#",
      "#.#.##.#.##.#.##.#.#",
      "#......#....#......#",
      "####.####..####.####",
      "#......#....#......#",
      "#.#.##.#.##.#.##.#.#",
      "#.#.##.#.##.#.##.#.#",
      "#.#....#....#....#.#",
      "#.##..##.##.##..##.#",
      "#........##........#",
      "####################"
    ]
  }
]